1111111111111111111111111
1111111111111111111111111
1111111111111111111111111
1111111111111111111111111
1111111111111100011111111
1111111111111107011111111
1111111111111100011111111
1111111711111110111111111
1111111011111110111111111
1111111011000000003111111
1111111011011111111111111
1111111000000111101211111
1111111111013110000001111
1111111111000000100001111
1111111111111110000001111
1111111111111111111111111
