1111111111111111111111111
1111111111111110111111111
1111111111111110111111111
1111111111111008031111111
1111111111111110001111111
1111111111111110021111111
1111111111111100111111111
1111111111111117111111111
1111110111111110111111111
1111110111111111111111111
1100000000111111111111111
1101111011111111111111111
1101111211111111111111111
1101111111111111111111111
1171111111111111111111111
1111111111111111111111111
