1111111111111111111111111
1111111111111111111111111
1111111111111111111111111
1111111111111111111111111
1111710111111111111111111
1111010000000001111111111
1111010111171100301111111
1111010000000001101111111
1111010111110101101111111
1111000111110080001111111
1111010111110111011111111
1111010111130000211111111
1111010111111111111111111
1111000111111111111111111
1111111111111111111111111
1111111111111111111111111
