1111111111111111111111111
1111111111111111111111111
1111111111111111111111111
1111111111111111111111111
1110000008020011111111111
1110010100003011111111111
1110000000300311111711111
1110111111111111111011111
1117111111111111111011111
1111111111111111111011111
1111111111111111000011111
1111111111111111011111111
1111111111111111012000111
1111111111111111011110111
1111111111111111000000111
1111111111111111111111111
