#########################
#########################
#########################
#########################
##############   ########
############## P ########
##############   ########
#######P####### #########
####### ####### #########
####### ##        x######
####### ## ##############
#######      #### #!#####
########## #x## 9   1####
##########      8   2####
############### 76543####
#########################
