#########################
########### x ###########
##### P####x x####P #####
#####   ####P####   #####
#####    ### ###    #####
#######x123456789x#######
######## ### ### ########
x!   ### ### xx    ######
###x ### 12345#### ######
#### ##  xxx#6#### ######
##    x #xx#x789 # ######
## #x##!#####x   # ######
##    #######12x #    ###
##x#xP  x###543 x ### ###
###     x###6789  !   x##
####x#xxx################
