######################x##
xP####################P##
# #################x   ##
#65432#############x #x##
#7##x1#############!  ###
#8 ##!##############x####
#9#######x##x############
#########x##x############
#########x##x############
#######x######x##########
########x####x###########
#########xxxx#####x######
################## !#####
# ###############x x#####
#P !#############x    P #
#x####################x##
