#########################
###############1#########
###############2#########
#############  34x#######
###############65 #######
###############7 !#######
##############98#########
###############P#########
###### ######## #########
###### ##################
##        ###############
## #### #################
## ####!#################
## ######################
##P######################
#########################
