#########################
#########################
#########################
#########################
####P# ##################
#### #         ##########
#### # ####P##  x #######
#### #  98765  ## #######
#### # #####4# ## #######
####   #####321   #######
#### # ##### ### ########
#### # ####x    !########
#### # ##################
####   ##################
#########################
#########################
