#########################
#########################
#########################
#########################
###   89 1 !  ###########
###  #7#32  x ###########
###   654 x  x#####P#####
### ############### #####
###P############### #####
################### #####
################    #####
################ ########
################ #!   ###
################ #### ###
################      ###
#########################
