#########################
##P      ################
## ## ## ################
## ## ## ################
##   9876################
## ## ##54    ###########
## ## ## 3#x# ###########
##      12    9##########
############ !8765#######
############  # #4#######
#############  123#######
############# # # #######
#############    P#######
#########################
#########################
#########################
