1111111111111111111111111
1170000001111111111111111
1101101101111111111111111
1101101101111111111111111
1100000001111111111111111
1101101100000011111111111
1101101100121011111111111
1100000080000001111111111
1111111111110300001111111
1111111111110010101111111
1111111111111008001111111
1111111111111010101111111
1111111111111000071111111
1111111111111111111111111
1111111111111111111111111
1111111111111111111111111
