1111111111111111111111111
1111111111111111111111111
1111111111111111111111111
1111111101111111111111111
1111117003111111111111111
1111111101111111111111111
1111100001111111111111111
1111170101111001111111111
1111100111110008000111111
1111100000000000000111111
1111100800110111111111111
1111111110110111111111111
1111111112000111111111111
1111111111111111111111111
1111111111111111111111111
1111111111111111111111111
