#########################
#xP!x x x x #############
#      1   ##############
#######2#################
#######345###############
######## 6###############
######## 789    #########
########  ####x #########
######56789###  Px   ####
######4   #####      ####
######3   #####      ####
###   2 ####### #########
###  x1##################
###  ####################
###!P####################
#########################
