#########################
##   ####################
## #x####################
##  9#!      ############
##P 8#xx     ############
##  7654321  ############
#########################
#########################
#########################
#########################
#####xxx    54321########
######### # 6############
######### # 7x###########
#########P# 8x###########
######### x 9  !#########
#########x###############