#########################
#########################
#########################
#########################
### P# ##################
#   ##         ##########
# ##P# ####P##  x #######
# ## #  98765  ## #######
# ## # #####4# ## #######
# ##   #####321   #######
# #### ##### ### ########
#    # ####x    P########
####456##################
####3#7##################
#! 12#89    !############
#########################
