#########################
##   ####################
## #x####################
##  9#!      ############
##P 8#xx     ############
##  7654321  ############
#########################
#########################
#########################
#########################
#########   54321########
######### ##6############
######### ##7############
#########P##8############
######### ##9  !#########
#########x###############

