#########################
#####       #############
##### ## ## #############
#####P##### #############
###########12345#########
###########!###6#########
############## 7#########
#############  8#########
###9#########P 9xx#######
##!81   P################
###72### #####x##x#######
###63### #####x##x#######
###54###x#####x##x#######
############x######x#####
############x######x#####
#############xxxxxx######
