#########################
#########################
#########################
#########################
####P# ##################
#### #         ##########
#### # ####P##  x #######
#### #      543## #######
#### # #####6#2## #######
####   #####7 1   #######
#### # #####8### ########
#### # ####x9   !########
#### # ##################
####   ##################
#########################
#########################
