##x######################
##P      ################
## ## ## ################
## ## ## ################
##   9876################
## ## ##54    ###########
## ## ## 3#x# ###########
#x      12    9##########
###x######## !8765#######
############  # #4#######
#############  123#######
#############x# # #######
#############x   P#######
#########################
#########################
#########################
