#########################
#########################
#########################
######## ################
######P  x###############
######## ################
#####    ################
#####P # ####  ##########
#####  #####   1234######
#####  234567 98765######
#####  1  ##8############
######### ##9############
#########!   ############
#########################
#########################
#########################
