#########################
#xP   !   x #############
#      1   ##############
#######2#################
#######345###############
######## 6###############
######## 789    #########
########  ####  #########
######56789## x P x  ####
######4   ####       ####
######3   #####      ####
###   2 ####### #########
###  x1##################
###  ####################
#!   P x#################
#########################
