#########################
#################x#######
####x########!1234#######
####x############5#######
##!  ############6 ######
#### ############7#######
#### ##########P98#######
#### ####################
#    ####################
#P   x#######!###########
##x###xxx#x## ###########
##x###x#x#x## ###########
##x###x#x#x   ###########
##xxx#xxx#xxx ###########
##########P   ###########
#########################